19
18
*******************
*B  *           G *
*** ***** *********
*       * *B     8*
*  *4     *       *
*7*   *** ****    *
***    5* *3      *
*   ***** *****   *
*   *         *   *
*   *         *   *
* 2 ***** *****   *
***    6* *5      *
*    **** ***   ***
*       *       *4*
*9     B* *       *
********* ***** ***
* g           *  B*
*******************