10
10
**********
**   **G**
**9   *  *
*4 ** ** *
**  *7   *
*** **** *
***   ** *
**  * ** *
*g **    *
**********

